30 20
m m m m m g g g g g g g w g g g g g g g g g g g g g g g g g
m m m m m g g g g g g g w g g g g g g g g g g g g g g g g g
m m m m g g g g g g r r r r r g g g g g g g g g g g g g g g
m m w w g g g g r r r w w w r r r r r r r r r r g g g g g g
w w w w r r r r r w w w w w g g g g g g g g g r g g g g g g
w w w w r w w w w w w w w w w g g g g g g g g r g g g g g g
g g w w r w w w w w w w w w w g g g g g g g g r r r r r r r
g g g g r g g g g g w w w w w m m m g g g g g g g g r g g g
g g g g r g g g g g w w w m m m m m m m g g g g g g r g g g
g g g g r g g g m m m m m m m m m m m m m g g g g g r g g g
g g g g r g g m m m m m m m m m w w w m m m g g g g r g g g
g g g r r g g m m g g w w m m m w w w m m m m g g g r g g g
g g r r g g g g g g g w w m m g g g r r m m m g g g r w w w
g g r g g g g g g g r r m m m g g g g r m m m g g r r w g g
g g r g g g r r r r r m m m m g g g g r m m m m g r w w g g
g g r g g r r g m m m m m m g g g g r r m m m m m r w g g g
g g r r r r g g m m m m m g g g g g r m m m m m m r w g g g
g g r g g g g m m m m g g g g g g g r m m m m r r r r g g g
g g r g g g g m m m g g g g g g g g r r r r r r w w w g g g
g g r g g g g g m m g g g g g g g g g g m m m w w g g g g g